11111111111111111
10NNNN000000NNNN1
1001CC000000100E1
100CC0000C0010001
10P00000011000NC1
10NC0000110000NC1
10N100001110N0001
11111111111111111